DIDIM	XOEVG
MXOSX	SYBMD
HVIPH	IICVI
CZNMH	PTTNU
OIFAC	IOGNW
XRDJP	DSQDV
KKFFD	LXZLE
QRMLK	DLSMX
TSOBM	NYPOG
SBGKN	YCTET
GQMWM	HDGCN
NYPTV	ASVUI
PALAW	JGMNQ
NQKKQ	TRXEW
ZWRTG	AJLZH
CZASH	PTGTU
HLSYM	BRTLG
WDDVR	CEQPX
LWZIR	MJTOS
NRFRR	ALLSE
DSENT	XYFAN
MOIRC	SPVLI
ZCUDV	APOJW
NNXSH	AHDTU
MGEDO	GMFQI
WPRSJ	CQEMP
KSAEY	LFUKZ
ZCQMO	MWWNB
CPBTU	WVCGO
MNKJF	SOXDL
WJCYD	XWWEE
DNCUT	QHIVG
FKDHC	ZQEUW
BMUEB	HNHYH
OJCAE	PWWGF
FWRQJ	SQXRW
VILCG	POMPA
UFVNE	AGIHK
ETLNB	FGFTC
ASLUG	NMRVT
CJUHS	WPVUM
GPNXO	MQARU
MXSPT	NKMVU
KJQBX	XDWCK
CDLUQ	WJMHK
INVDJ	OOIXP
ZNALO	AAURP
YTOWD	LNUXQ
WFNAZ	QLONT
WEDPQ	CFQJW